000000000
010000010
000000000
001100000
001000000
000000000
000000100
001100000
000000000

